11111111111111111111111111111
1                           1
1                           1
1                           1
1                           1
1111115                211111
1                           1
1                           1
1111113                     1
1111111                     1
1                           1
1                           1
1                  2111111111
1                           1
1                           1
1                           1
1                           1
1                           1
1                           1
1                           1
11111111111111111111111111111

1:res/textures/center.png
2:res/textures/left_edge.png
3:res/textures/right_margin.png
4:res/textures/left_margin.png
5:res/textures/right_edge.png
