11111111111111111111111111111
4                           4
4                           4
4                           4
4777778                677774
4111112                011114
4                           4
4                           4
4777778                     4
4111112                     4
4                           4
4                           4
4                  6777777774
4                  0111111114
4                           4
4                           4
4                           4
4             p             4
4                           4
4                           4
77777777777777777777777777777
s:res/textures/mapsheet.png 8 8
